~~~~~~~~~~~~~~~~~~~~~~~~~
~~~#####~~~~~~~~~~~~~~~~~
~~~~~~~~~~~~~~~~~~~~~~~~~
~~~~~~~~~~~~~~~~~~~~~~~~~
~~~~~~~~~~~~~~~~#~~~~~~~~
~~~~~~~~~~~~~~~~#~~~~~~~~
~~~~~~~~~~~~~~~~#~~~~~~~~
~~~#~~~~~~~~~~~~#~~~~~~~~
~~~#~~~~~~~~~~~~#~~~~~~~~
~~~#~~~~~~~~~~~~~~~~~~~~~
~~~#~~~~~~~~~~~~~~~~~~~~~
~~~#~~~~~~~~~~~~~~~~~~~~~
~~~~~~~~~~~~~#####~~~~~~~
~~~~~~~~~~~~~~~~~~~~~~~~~
~~~~~~~~~~~~~~~~~~~~~~~~~
~~~~#~~~~~~~~~~~~#~~~~~~~
~~~~#~~~~~~~~~~~~#~~~~~~~
~~~~#~~~~~~~~~~~~#~~~~~~~
~~~~#~~~~~~~~~~~~#~~~~~~~
~~~~#~~~~~~~~~~~~#~~~~~~~
~~~~~~~~~~~~~~~~~~~~~~~~~
~~~~~~~~~~~~~~~~~~~~~~~~~
~~~~~~~~~~~~~~~~~~~~~~~~~
~~~~~~~~~~~~~~#####~~~~~~
~~~~~~~~~~~~~~~~~~~~~~~~~